6111111111111111111111111111111111111111111111111111111111111111111111111111111111111111
1000000000000000000000000000000000000000000000000000000000000000000000000000000000000001
1000000000000000000000000000000000000000000000000000000000000000000000000000000000000001
1000000000000000000000000000000000000000000000000000000000000000000000000000000000000001
1000000000000000000000000000000000000000000000000000000000000000000000000000000000000001
1000000000000000000000000000000000000000000000000000000000000000000000000000000000000001
1000000000000000000000000000000000000000000000000000000000000000000000000000000000000001
1000000001110000000111111111111100000000000000000000000000000000000000000000000000000001
1000000001210000000100002000000100000000000000000000000000000000000000000000000000000001
1000000001210000000111112111111100000000000000000000000000000000000000000000000000000001
1000000001210000000000012100000000000000000000000000000000000000000000000000000000000001
1000000001210000000000012100000000000000000000000000000000000000000000000000000000000001
1000000001210000000000012100000000000000000000000000000000000000000000000000000000000001
1000011111311111111111113100000000000000000000000000000000000000000000000000000000000001
1000000000200000000000002000000000000000000000000000000000000000000000000000000000000001
1111111111111111111111111111111111111111111111111111111111111111111111111111111111111111
