1111111111111111111111111111111111111111119111111111111111111111111111111111111111111111
1000000000000000000000002000000000000061000000000000000000000000000000000000000000000001
1000000000000000000000002000000000001121000000000000000000000000000000000000000000000001
1000000000000000000000002000000000001160000000000000000000000000000000000000000000000001
1000000000000000000000002000000000000061111100000000000000000000000000000000000000000001
1000000000000000000111112111111111111121000000000000000000000000000000000000000000000001
1000000000000000000000002000000000000061000000000000000000000000000000000000000000000001
1111111111110000000111112111111111111121000000000000000000000000000000000000000000000001
1000000001310000000100002000000100000121000000000000000000000000000000000000000000000001
1000000001210000000111112111111100000121000000000000000000000000000000000000000000000001
1000000001210000000000012100000000000121000000000000000000000000000000000000000000000001
1000000001210000000000012100000000000121000000000000000000000000000000000000000000000001
1000000001210000000000012100000000000121000000000000000000000000000000000000000000000001
1000011111211111111111112111111111111121000000000000000000000000000000000000000000000001
1000000000200000000000002000000000000020000000000000000000000000000000000000000000000001
1000000000200000000000002000000000000020000000000000000000000000000000000000000000000001
1000000000200000000000002000000000000020000000000000000000000000000000000000000000000001
1111111111111111111111111111111111111111111111111111111111111111111111111111111111111111
