1111111111111111111111111111111111111111119111111111111111111111111111111111111111111111
1000000000000000000000000000000000000000000000000000000000000000000000000000000000000001
1000000000000000000000000000000000000000000000000000000000000000000000000000000000000001
1000000000000000000000000000000000000111000000000000000000000000000000000000000000000001
1000000000000000000000000000000000000131000000000000000000000000000000000000000000000001
1000000000000000000111111111111111111121000000000000000000000000000000000000000000000001
1000000000000000000000000000000000000061000000000000000000000000000000000000000000000001
1111111111110000000111111111111111111121000000000000000000000000000000000000000000000001
1000000001310000000100004000000100000121000000000000000000000000000000000000000000000001
1000000001210000000111112111111100000121000000000000000000000000000000000000000000000001
1000000001210000000000012100000000000121000000000000000000000000000000000000000000000001
1000000001210000000000012100000000000121000000000000000000000000000000000000000000000001
1000000001210000000000012100000000000121000000000000000000000000000000000000000000000001
1000011111211111111111112111111111111121000000000000000000000000000000000000000000000001
1001000001500000000000105000000000000050000000000000000000000000000000000000000000000001
1111111111111111111111111111111111111111111111111111111111111111111111111111111111111111
